                                                /-----------------------------------------------------------------\                                   
                                                |    /------------------------------\                             |                                   
       /----------------------------------------+----+------------------------------+----------------------------\|                                   
       |     /----------------------------------+----+--|     >---------------------+----------------------------++------------------------------\    
       |     |                             /----+----+--+-----+---------------------+----------------------------++-------\                      |    
       | /---+-----------------------------+----+----+--+-----+---------------------+--------------\             ||       |                      |    
       | | /-+-----------------------------+----+----+--+-----+----------------\  /-+--------------+-------------++-------+-----\                |    
       | | | |     /-----------------------+----+----+--+--\  |                |  | |             /+-------------++-------+-----+\               |    
       | | | |     |                       |    |    |  |  |  |                |  | |     /-------++-------------++-------+-----++--\            |    
   /---+-+-+-+-----+---------------\       |  /-+----+--+--+--+----------------+--+-+-----+-------++-------------++-------+-----++--+------------+\   
   |   | | | |     |               |      /+--+-+----+--+--+--+----------------+--+-+-----+-------++-------------++-------+-----++--+------------++--\
   |   | | | |     |               |      ||  | |   /+--+--+--+---------\ /----+--+-+-----+-------++-------------++--\    |     ||  |            ||  |
   |   | | | |     |               |      ||  | |   ||/-+--+--+---------+-+----+--+-+-----+-------++-------------++--+----+---\ ||  |            ||  |
   |   | | | |     |               |      ||  | |   |\+-+--+--+---------+-+----+--+-\     |       ||             ||  |    |   | ||  |            ||  |
   | /-+-+-+-+-----+---------------+------++--+-+---+-+\|  |  |         | |/---+--+-------+-------++-----------\ ||  |    |   | ||  |            ||  |
   | | | | | |     |  /----------\ |      ||  | |   | |||  |  |         | ||   |  |       |       ||           | ||  |    |   | ||  |            ||  |
   | | | | | |     | /+----------+\|      ||  | |   | |||  |  |        v+-++---+--+-------+-------++-----------+-++-\|    |   | ||  |            ||  |
   | | | | | \-----+-++----------+++------++--+-+---+-++/  |  |v-------++-++---+--+-------+-------++---\       | || ||    |   | ||  |            ||  |
   | | | | |     /-+-++----------+++------++--+-+---+-++---+--++-------++-++---+--+---\   |       ||   |       | || ||    |   | ||  |            ||  |
   | | | | |     | | ||          |||      ||  | |   | || |-+--++-----\ || ||   |  |   |   |       ||   |       | || ||    |   | ||  |            ||  |
   | | | | |     | | ||         /+++------++--+-+---+-++-+-+--++-----+-++-++---+--+---+---+-\     ||   |       | || ||    |   | ||  |            ||  |
   | | | | |     | | ||     /---++++-\ /--++--+-+---+-++-+-+--++-----+-++-++---+--+---+---+-+-----++---+-------+-++-++----+---+-++--+------------++\ |
   | | | | |     | | ||     |   |||| | |  ||  | |   | || | |  ||     | || ||   |  |   |   | |     ||   |       | || ||    |/--+-++--+----------\ ||| |
   | | | | |     | | || /---+---++++-+-+--++-\| |   | || | |  ||     | ||/++---+--+---+---+-+-\   ||   |       | || ||    ||  | ||  |          | ||| |
   | | | | |     | | || |   |   |||| | |  || || |   | || | |  ||/----+-+++++---+--+---+---+-+-+---++---+-------+-++-++----++--+-++--+-----\    | ||| |
   | | | | |     | | || |   |   |||| | |  || || |   | || | |  |||    | \++++---+--+---+---+-+-+---++---+-------+-++-/|    ||  | ||  |     |    | ||| |
   \-+-+-+-+-----+-+-++-+---+---+++/ | |  \+-++-+---+-++-+-+--+++----+--++++---+--+---+---+-+-+---++---+-------+-++--+----++--+-++--+-----+----+-+++-/
   /-+-+-+-+-----+-+-++-+---+---+++--+-+---+-++-+---+-++-+-+--+++----+--++++---+--+---+---+-+-+---++---+-\     | ||  |    ||  | ||  |     |    | |||  
   | | | | |     | | || |   |   |||  | |   | || |   | || | |/-+++----+--++++---+--+---+---+-+-+---++---+-+-----+-++--+---\||  | ||  |     |    | |||  
   | | | | |     | | || |   |   ||| /+-+---+-++-+---+-++-+-++-+++----+--++++---+--+---+---+-+-+-->++---+-+-----+-++--+---+++--+-++--+---\ |    | |||  
   | | | | |     | | || |   |   ||| || |  /+-++-+---+-++-+-++-+++----+--++++---+--+---+---+-+-+---++---+-+-----+-++--+---+++--+-++--+\  | |    | |||  
   | | | | |     \-+-++-+---+---+++-++-+--++-++-+---+-++-+-++-+++----+--++++---+--+---/   | | |   ||   | | /---+-++--+---+++--+-++--++--+-+---\| |||  
   | | | | |       |/++-+---+---+++-++-+--++-++-+---+-++-+-++-+++----+--++++---+--+-----\ | | |   \+---+-+-+---+-++--+---+++--+-+/  ||  | |   || |||  
   | |/+-+-+-------++++-+--\|   ||| || |  |\-++-+---+-++-+-++-+++----+--++++---+--+-----+-+-+-+----+---+-+-+---+-++--+---+/|  | |   ||  | |   || |||  
   | ||| | |    |--++++-+--++---+++-++-+--+--++-+---+-++-+-++-+++----+--++++---+--+-----+-+-+-+----+-\ | | |   | ||  |   | |  | |   ||  | |   || |||  
   | ||| | |    |  |||| |  ||   ||| || |  ^/-++-+---+-++-+-++-+++----+--++++---+--+-----+-+-+-+----+-+-+-+-+---+-++--+---+-+--+-+---++--+-+---++-+++\ 
   | ||| | |    |  |||| |  ||   ||| || |  || || |  /+-++-+-++-+++----+--++++---+--+-----+-+-+-+-\  | | | | |   | ||  |   | |  | |   ||  | |   || |||| 
   | ||| | |    |  |||| |  ||   ||| || |  || || |  || || | || |||/---+--++++---+--+-----+-+-+-+-+--+-+-+-+-+---+-++-\|   | |  | |   ||  | |   || |||| 
  >+-+++-+-+----+--++++\|  ||   ||| || |  || || |  || || | || ||||   |  ||||/--+--+-----+-+-+-+-+--+-+-+-+-+---+-++-++---+-+--+-+-\ ||  | |   || |||| 
 /++-+++-+-+----+--++++++--++---+++-++-+--++-++-+--++-++-+-++-++++---+--+++++--+--+-----+-+-+-+-+--+-+-+\| |   | || ||   | |  | | | ||  | |   || |||| 
 ||| ||| | |    |  ||||||  ||   ||| || |/-++-++-+--++-++-+-++-++++---+--+++++--+--+-----+-+-+-+-+--+-+-+++-+---| || ||   | |  | | | ||  | |   || |||| 
/+++-+++-+-+---\|  ||||||  ||   ||| || || || || |  || || |/++-++++---+--+++++--+--+-----+-+-+-+-+--+-+-+++-+--++-++-++---+-+--+-+-+-++--+-+---++\|||| 
|||| ||| | |   ||  ||||||  ||/--+++-++-++-++-++-+--++-++-++++-++++---+--+++++--+--+-----+-+-+-+-+-\| | ||| |  || || ||   | |  | | | ||  | |   ||||||| 
|||| ||| | |   ||  |||||| /+++--+++-++-++-++-++-+--++-++-++++-++++---+--+++++--+--+-----+-+-+-+-+-++-+-+++-+--++-++-||   | |  | | | ||  | |   ||||||| 
|||| ||| | |   ||  |||||| ||||  ||| || ||/++-++-+--++-++-++++-++++---+--+++++--+--+-----+-+-+-+-+-++-+-+++-+--++-+++++---+-+--+-+-+-++--+-+\  ||||||| 
|||| ||| v |   ||  |||||| ||||  ||| || ||||| || |  || || |||| ||||   |  |||||  |  |     | | | | | || | ||| |  || |||||   | |  | | | ||  | ||  ||||||| 
|||| ||| | |   ||  |||||| ||||  ||| || ||||| || |  || || |||| ||||/--+--+++++--+--+-----+-+-+-+-+-++-+-+++-+--++-+++++---+-+--+-+-+-++\ | ||  ||||||| 
|||| ||| | |   ||  |||||| ||||  ||| || ||||| || |  || || |||| |||||  |  ||\++--+--+-----+-+-+-+-+-++-+-+++-+--++-++++/   | |  | | | ||| | ||  ||||||| 
|||| ||| | |   ||  |||||| ||||  ||| || ||||| || |  || || |||| |||||  |  || ||  |  |     | | | | | || | ||| |  || ||||    | |  | | | ||| | ||  ||||||| 
|||| ||| | |   ||  |||||| ||||  ||| || ||||| || |  || || |||| |||||  |  || ||  |  |     | |/+-+-+-++-+-+++-+--++-++++----+-+--+-+-+\||| | ||  ||||||| 
|||| ||| | |   ||  |||||| ||||  ||| ||/+++++-++-+--++-++-++++-+++++--+--++-++--+--+\    | ||| |/+-++-+-+++-+\ || ||||    | |  | | ||||| | ||  ||||||| 
|||| ||| | | /-++--++++++-++++\ ||| ||||||||/++-+--++-++-++++-+++++--+--++-++--+--++-\  | ||| ||| || | ||| || || ||||    | |  | | ||||| | ||  ||||||| 
|||| ||| | | | ||  ||\+++-+++++-++/ ||||||||||| | /++-++-++++-+++++--+--++-++--+--++-+--+-+++-+++-|| | ||| || || ||||    | |  | | ||||| | ||  ||||||| 
|||| ||| | | | ||  || ||| ||||| ||  ||||||||||| | ||| || |||| |||||  |  || ||  |  || |  | ||| |||||| | ||| || || ||||    | |  | | ||||| | ||  ||||||| 
|||| ||| | | | ||  || ||| ||||| ||  ||||||||||| | ||| || |||| |||||  |  || \+--+--++-+--+-+++-++++++-+-+++-++-+/ ||||    | |  | | ||||| | ||  ||||||| 
|||| ||| | | | ||  || ||| ||||| ||  ||||||||||| | ||| || |||| |||||  |  ||  |  |  || |  | ||| |||||| | ||| || |  ||||    | |  | | ||||| | ||  ||||||| 
|||| ||| | | | ||  || |||/+++++-++--+++++++++++-+-+++-++-++++-+++++--+--++--+--+--++-+--+-+++-++++++-+-+++-++-+-\||||    | |  | | ||||| | ||  ||||||| 
|||| ||| | | | ||  || \++++++++-+/  ||||||||||| | ||| || |||\-+++++--+--++--+--+--++-+--+-+++-++++++-+-+++-++-+-+++++----/ |  | | ||||| | ||  ||||||| 
||\+-+++-+-+-+-++--++--/||||||| |   ||||||||||| | ||| || |||  >++++--+--++--+--+--++-+--+-+++-++++++-+-+++-++-+-+++++------+--+-+-+++++-+-++--+++/||| 
|| ||+++-+-+-+\||  |\---+++++++-+---+++++++++++-+-+++-++-+++---++++--+--++--+--+--++-+--/ ||| |||||| | ||| || | |||||      |  | | ||||| | ||  ||| ||| 
|| ||||| | | ||||  |    ||||||| |   ||||||||||| | ||| || |||   ||||  |/-++--+--+--++-+\   ||| |||||| | ||| || | |||||      |  | | ||||| | ||  ||| ||| 
|| |||\+-+-+-++++--+----+++/||| \---+++++++++++-+-+++-++-+++---++++--++-++--+--+--++-++---++/ |||||| | ||| || | |||||      |  | | ||||| | ||  ||| ||| 
|| ||/-+-+-+-++++--+----+++-+++-----+++++++++++-+-+++-+/ |||   |||| /++-++--+--+--++-++---++\ |||||| | ||| || | |||||      |  | | ||||| | ||  ||| ||| 
|| ||  | | | ||||  |    ||| |||     ||||||||||| | ||| |  |\+---++++-+++-++--+--+--++-++---+++-++++++-+-+++-++-+-+++++------+--+-+-+++++-+-++--++/ ||| 
|| ||  | | | ||||  |    ||| |||     ||||||||||| | ||| |  | |   ||\+-+++-++--+--+--++-++---+++-++++++-+-+++-++-+-++++/      \--+-+-+++++-+-++--+/  ||| 
|| ||  | | | ||||  |    ||| |||     ||||||||||| | ||| |  | |   || | ||| ||  |  |  || ||   ||| |||||| | ||| || | ||||          | | ||||| | ||  |   ||| 
|| ||  | | | ||||  |    ||| |||     ||||||||||| | ||| |  \-+---++-+-+/| ||  |  |  || ||   ||| |||||| | ||| || | ||||          | | ||||| | ||  |   ||| 
|| ||  |-+-+-++++--+\   ||| |||     ||||||||||| | ||| |    |   \+-+-+-+-++--+--+--++-++---+++-++++++-+-/|| || | ||||          | |/+++++-+-++--+-\ ||| 
|| ||  ||| |/++++--++---+++-+++-----+++++++++++-+-+++-+----+----+-+-+-+-++--+--+--++-++---+++-++++++-+-\|| || | ||||          | ||||||| | ||  | | ||| 
|| ||  ||| ||||||  ||   ||| |||     ||||||||||| |/+++-+----+----+-+-+-+-++--+--+--++-++-\|+++-++++++-+-+++-++-+-++++----------+-+++++++-+-++--+-+\||| 
\+-++--+++-++++/|  ||   ||| |||     ||||||||||| ||||| |    |    | | | | ||  |  |  ||/++-+++++-++++++-+-+++-++-+-++++----------+-+++++++-+-++\ | ||||| 
 | ||  ||| |||| |  ||   ||| |||     ||||||||||| ||||| |    |    | | | | ||  |  |  ||||| ||||| |||||| | ||| || | ||||  /-------+-+++++++-+\||| | ||||| 
 |/++--+++-++++-+--++---+++-+++---\ ||||||||||| ||||| |   >+----+-+-+-+-++--+--+--+++++-+++++-+++>++-+\||| || | ||||  |       | ||||||| ||||| | ||||| 
 ||||  ||| |||| |  || /-+++-+++---+-+++++++++++\||||| |   ||    | | | | ||  |  |  ||||| |||||/++++++-+++++-++-+-++++--+-------+-+++++++-+++++-+\||||| 
 ||||  ||| |||| |  || | ||\-+++---+-+++++++++++++++++-+---++----+-+-+-+-++--+--+--+++++-++++++++++++-+++++-++-+-+++/  |       | ||||||| ||||| ||||||| 
 ||||  ||| |||| |  || | ||  |||   |/+++++++++++++++++-+---++----+-+-+-+-++--+--+--+++++-++++++++++++-+++++-<+-+-+++---+-------+-+++++++-||||| ||||||| 
 |||---+++-+++/ |  || |/++--+++---+++++++++++++++++++\|   ||    | | | | ||  |  |  ||||| |||||||\++++-+++++-+| | |||   |       | ||||||||||||| ||||||| 
 |||   ||| |||  |  || ||||  |||   |||||\+++++++++++++++---++----+-+-+-+-++--+--+--+++++-+++++++-++++-+++++-+--+-+++---+-------+-+++++++++++++-+++++/| 
 |||   ||| |||  |  || ||||  |||/--+++++-+++++++++++++++---++----+-+-+-+-++--+--+--+++++-+++++++-++++-+++++\|  | |||   |       | ||||||||||||| ||||| | 
 |||   ||| |||  |  || |||| >++++--+++++-+++++++++++++++---++----+-+-+-+-++--+--+-|||||| ||||||| |||| |||||||  | |||   |       | ||||||||||||| ||||| | 
 |||   ||| |||  |  || |||| |||||  ||||| |||||||||||\+++---++----+-+-+-+-++--+--+-++++++-+++++++-/||| |||||||  | |||   |       | ||||||||||||| ||||| | 
 |||   ||| |||  |  || |||| |||||  ||||| |||||||||||/+++---++----+-+-+-+-++--+--+-++++++-+++++++--+++-+++++++--+-+++---+----\  | ||||||||||||| ||||| | 
 |||   ||| |||  |  || |||| |||||  ||||| |||||||||||||||   ||    | | | | ||  |  | |||||| |||||||  ||| |||||||  | |||   |    |  | ||||||||||||| ||||| | 
 |||   ||| |||  |  || |||| |||||  ||||| |||||||||||||||   ||    | | | | ||  |  | |||||| |||||||  ||| |||||||  | |||   |    |  | ||||||||||||| ||||| | 
 |||   ||| |||  |  || |||| |||||  ||||| ||||||||||||||\---++----+-+-+-+-++--+--+-++++++-+++++++--+++-+++++++--+-+++---+----+--/ ||||||||||||| ||||| | 
 |||   ||| |||  |  || |||| |\+++--+++/| ||||||||||||||    ||    | | | | ||  |  | |\++++-+++++++--+++-+++++++--+-+++---+----+----/||||||^||||| ||||| | 
 |||   ||| |||/-+--++-++++-+-+++--+++-+-++++++++++++++----++----+-+-+-+-++--+--+-+-++++-+++++++--+++-+++++++--+-+++---+-\  |     |||||||||||| ||||| | 
 |||   ||| |||| |  || |||| |/+++--+++-+-++++++++++++++----++----+-+-+-+-++--+--+-+-++++-+++++++--+++-+++++++--+-+++---+-+--+---\ |||||||||||| ||||| | 
 |||   ||| |||| |  || |||| |||||  ||| | ||||||||||||||---->+----+-| | | ||  |  | | |||| |||||||  ||| |||||||  | |||   | |  |   | |||||||||||| ||||| | 
 |||   ||| ||\+-+--++-++++-+++/|  ||| |/+++++++++++++++\  ||    ||| | | ||  |  | | |||| |||||||  ||| |||||||  | |||   | |  |   | |||||||||||| ||||| | 
 |||   ||| || | |  ||/++++-+++-+--+++-++++++++++++++++++--++----+++-+-+-++--+--+-+-++++-+++++++--+++-+++++++--+-+++-\ | |  |   | ||v||||||||| ||||| | 
 |||   ||| || | |  ||||||| ||| |  ||| ||||||||||||||||||  ||    ||| | | |-<-+--+-+-++++-++++++/  ||| |||||||  | ||| | | |  |   | |||||||||||| ||||| | 
 |||   ||\-++-+-+--+++++++-+++-+--+++-++++++++++++++++++--++----+++-+-+-+---+--+-+-++++-++++++---++/ |||||||  | |||/+-+-+--+---+-++++++++++++-+++++\| 
 |||   || /++-+-+--+++++++-+++||  |\+-++++++++++++++++++--++----+++-+-+-+---+--+-+-++++-++++++---++--+++++++--+-+++++-+-+--+---+-++++++/||||| ||||||| 
 |||   || ||| | |  ||||||| |||||  | | |||||||||||\++++++--++----+++-+-+-+---+--+-+-++++--|||||   ||  |||||||  | ||||| | |  |   | |||||| ||||| ||||||| 
 |||   || ||| | |  ||||||| |||||  | | ||||||||||| ||\+++--++----+++-+-+-/   |  | | ||||  |\+++---++--+++++++--+-+++++-+-+--+---+-+++/|| ||||| ||||||| 
 /++---++-+++-+-+--+++++++-+++++--+-+-+++++++++++-++-+++--++----+++-+-+-----+--+-+-++++--+-+++---++--+++/|||  | ||||| | |  |   | ||| || ||||| ||||||| 
  ||   || ||| | |  ||||||| |||||  | | ||||\++++++-++-+++--++----+++-+-+-----+--+-+-++++--+-+++---++--+++-+++--+-+++++-+-+--+---+-+++-/| ||||| ||||||| 
  ||   || |\+-+-+--+++++++-+++++--+-+-++++-++++++-++-+++--++----+++-+-+-----+--/ | ||||  | |||   ||  ||| |||  | ||||| | |  |   | |||  | ||||| ||||||| 
  ||  \++-+-+-+-+\/+++++++-+++++--+-+-++++-++++++-++-+++--++----+++-+-+-----+----+-++++--+-+++---++--+++-+++--+-+++++-+-+\ |   | |||  | ||||| ||||||| 
  ||  ||| | | | |||||||||| |||||  | | |||| |||||| || |-+--++----+/| | \-----+----+-+++/  | \++---++--+++-+++--+-+++++-+-++-+---+-++/  | ||||| ||||||| 
  ||  ||| | |/+-++++++++++-+++++--+\| |||| |||||| || | |  ||    | | |       |    | |||   |  ||   ||  ||| |||  | ||||| | || |   | ||   | ||||| ||||||| 
  ||  ||| | ||| |||||||||| ||||\--+++-++++-++++++-++-+-+--++----+-+-+-------+----+-+++---+--++---++--+++-+/|  | ||||| /-++-+---+-++---+-+/||| ||||||| 
  ||  ||| | ||| |||||||||| ||||   ||| |||| |||||| || | |  ||/---+-+-+-------+----+-+++---+--++---++-\||| | |  | |||||   || |   | ||   | | ||| ||||||| 
  ||  ||| | ||| |||||||||| ||||   ||| |||| |||||| || | |  |||   \-+-+-------+----+-+++---+--++---++-++++-+-+--+-+++++---++-+---+-++---+-+-/|| ||||||| 
  ||  ||| | ||| |||||||||| |-++---+++-++++-++++++-++-+-+--+++-----+-+-------+----+-+++---+--++---++-++++-+-+--+-+++++---++-+---^ ||   | |  || ||||||| 
  ||  ||| | ||| |||\++++++-+-++---+++-++++-++++++-++-+-+--+-|     | |       |    | |||   |  ||   || |||| | |  | |||||   || |     ||   | |  || ||||||| 
  ||  |\+-+-+++-+++-++++++-+-++---+++-++++-++++++-++-+-+--+-+-----+-+-------+----+-+++---+--++---++-++++-+-+--+-+/|||   || |     ||   | |  || ||||||| 
  ||  | | | ||| ||| |||||| | ||   ||| |||| |||||\-++-+-+--+-+-----+-+-------+----+-+++---+--++---++-++++-+-+--+-+--||   || |     ||   | |  || ||||||| 
  ||  | | | ||| ||| |||||| | ||   ||| \+++-+++++--++-+-+--+-+-----+-+-------+----+-/||   |  ||   || |||| | |  | |  ||   || |     ||   | |  || ||||||| 
  ||  | | | |||/+++-++++++\| ||   |||  X-+-+++++--++-+-+--+-+-----+-+-------+----+--++---+--++---++-++++-+-+--/ |  ||   || |     ||   | |  || ||||||| 
  ||  /-+-+-+++++/| ||||\+++-++---+++--+-+-++|||  || | |  | |     | |       |    |  ||   |  ||   || |||| | |    |  ||   || |     ||   | |  || ||||||| 
  ||    | | ||||| | |||| ||| ||   |||  | | |\-++--++-+-+--+-+-----+-+-------+----+--+/   |  ||   || |||| | |    |  ||   || |     ||   | |  || ||||||| 
  /+----+-+-+++++-+-++++-+++-++---/||  | | \--++--++-+-+--+-+-----+-+-------+----+--+----+--++---++-++++-+-+----+--++---++-+-----++---+-+--++-++++++/ 
   |    | \-+++++-+-++++-+++-+/    ||  | |    \+--++-+-+--+-+-----+-+-------+----+--+----+--++---++-++++-+-+----+--++---++-+-----++---+-+--++-++++/|  
   |    |   |||||/+-++++-+++-+-----++--+-+-----+--++-+-+--+-+--\  | |       \----+--+----+--++---++-++++-+-+----+--++---++-+-----+/   | |  || |||| |  
   |    | /-+++++++-++++\||| |     ||  | |     |  || | |  | |  |  | |            |  |    |  ||   || |||| | /----+--++---++-+-----+----+-+--++-/||| |  
   |    | | ||||||| |||||||| |     ||/-+-+-----+--++-+-+--+-+--+--+-+------------+--+----+--++---++-++++-+------+--++---++-+\    |    | |  ||  ||| |  
   |    | | ||||||| |||||||| |     ||| | |     |  || | |  | |  |  | |            |  \----+--++---++-++++-+------+--++---++-++----+----+-+--+/  ||| |  
   |    | | ||||||| |||||||| |  /--+++-+-+-----+--++-+-+--+-+--+--+-+------------+----\  |  ||   || |||| |      |  ||   || ||    |    | |  |   ||| |  
   |    | | ||||||| |||||||| |  |  |\+-+-+-----+--++-+-+--+-+--+--+-+------------+----+--+--++---++-++++-+------+--++---++-++----+----+-/  |   ||| |  
   \----+-+-+++++++-++++++++-+--+--+-+-+-+-----+--++-+-+--+-+--+--+-+------------+----+--+--++---++-++++-/  /---+--++--\|| ||    |    |    |   ||| |  
        | | ||||||| |||||||| |  |  | | | |     |  || | |  | |  |  | |            |    |  |  ||   || ||||    |   |/-++--+++-++----+----+--\ |   ||| |  
        | | ||||||| |||||||| |  |  | | | |   /<+--++-+-+--+-+--+--+-+------------+----+--+--++---++-++++---\|   || ||  ||| ||    |    |  | |   ||| |  
        | | ||\++++-++++++++-+--+--+-+-+-+---+-+--++-+-+--+-+--+--+-+------------+----+--+--++---++-++++---++---++-++--+/| ||    |    |  | |   ||| |  
        | | || |||| |||\++++-+--+--+-+-+-+---+-+--++-| |  | |  |  | |            |    |  |  ||   || ||||   ||   || ||  | | ||    |    |  | |   ||| |  
        | | || |\++-+++-++++-+--+--+-+-+-+---+-+--++---+--+-+--+--+-+------------+----+--+--++---++-+/||   ||   || ||  | | ||    |    |  | |   ||| |  
        | | || | || ||| |||| |  |  | | | |   | |  ||   |  | |  |  | |            |    |  |  ||   || | ||   ||   || ||  | | ||    |    |  | |   ||| |  
        | | || | || ||| |||| |  |  | | | /---+-+--++---+--+-+--+--+-+------------+----+--+--++---++-+-++---++---++-++--+-+-++----+----+--+-/   ||| |  
        | | || | \+-+++-++++-+--+--+-+-+-----+-+--++---+--+-+--/  | |            |    |  |  ||   || | ||   ||   || ||  | | ||    |    |  |     ||| |  
        | | || |  | ||| |||| |  \--+-+-+-----+-+--++---+--+-+-----+-+------------+----/  |  ||   || | || /-++---++-++--+-+-++----+--\ |  |     ||| |  
        \-+-++-+--+-/|| |||| |     | | |     | |  ||   |  | |     | |       /----+-------+--++---++-+-++-+-++-\ || \+--+-+-++----+--+-+--+-----+++-/  
          | || |  |  || |||| |     | | /-----+-+--++---/  | |     | |       |    |       |  ||   || | || | || | ||  |  | | ||    |  | |  |     |||    
          | || |  |  \+-++++-+-----+-+-------+-+--++------+-+-----+-+-------+----+-------+--++---++-+-++-+-++-+-++--/  | | ||    |  | |  |     |||    
          | || |  |   | |||| |     | \-------+-+--++------+-+-----+-+-------+----+-------+--++---++-+-++-+-++-+-++-----+-+-+/    |  | |  |     |||    
          | || |  |   | |||| |     |         |-+--++------+-+-----+-+-------+----+-------+--++---++-+-++-+-/| | ||     | | |     |  | |  |     |||    
          | || |  |   | |\++-+-----+-----------+--++------+-+-----+-+-------+----+-------+--++---++-+-++-+--+-+--|     | | |     \--+-+--+-----+/|    
          | \+-+--+---+-+-++-+-----+-----------+--++------+-+-----+-+-------+----+-------+--++---++-+-+/ |  \-+->+-----/ | |        | |  |     | |    
          |  | |  \---+-+-++-+-----+-----------+--++------+-+-----+-+-------+----+-------+--++---++-+-+--+----+--+-------/ |        | |  |     | |    
          \--+-+------+-/ || \-----+-----------+--++------+-+-----+-+-------+----+-------+--++---+| | |  /----+--+---------+--------/ |  |     | |    
             | |      |   ||       |           |  ||      \-+-----+-+-------+----+-------+--++---+--+-/       |  \---------+----------+--/     | |    
             | |      |   ||       |           |  ||        |     | \-------+----+-------+--||   |  |         |            |          |        | |    
             | |      |   ||       |           |  ||        \-----+---------+----+-------+---+---+--/         |            |          |        | |    
             \-+------+---++-------/           |  ||              |         |    |       |   |   |            |            |          |        | |    
               |      |   ||                   |  |\--------------+---------+----+-------+---+---+------------+------------/          |        | |    
               \------+---/|                   |  |               |         |    |       |   \---+------------+-----------------------+--------/ |    
                      |    |                   |  |               \---------+----+-------+-------+------------+-----------------------/          |    
                      \----+-------------------/  |-------------------------+----+-------+-------/            |                                  |    
                           \------------------------------------------------+----|       \--------------------+----------------------------------/    
                                                                            ^---------------------------------\                                       
